********----------------********
*______________________________*
*______________________________*
*______________________________*
*______________________________*
*______________________________*
*______________________________*
________________________________
________________________________
________________________________
________________________________
________________________________
________________________________
________________________________
________________________________
________________________________
________________________________
________________________________
________________________________
________________________________
________________________________
________________________________
________________________________
________________________________
________________________________
*______________________________*
*______________________________*
*______________________________*
*______________________________*
*______________________________*
*______________________________*
********----------------********