*******------*******
*------------------*
*------------------*
*------------------*
*------------------*
*------------------*
------*------*------
------*------*------
------*------*------
------*------*------
------*------*------
------*------*------
------*------*------
------*------*------
*------------------*
*------------------*
*------------------*
*------------------*
*------------------*
*******------*******